1111111111111
100100000C0C1
1110011111001
1P0011E000001
1111111111111