1111111111111
100100000C0C1
100100S00C0C1
100100S00C0C1
1S01000S0C0C1
111S011111001
1P0001E0000S1
1S00C100S00S1
1111111111111